//MAP CONVERTED BY dmm2tgm.py THIS HEADER COMMENT PREVENTS RECONVERSION, DO NOT REMOVE
"a" = (
/turf/open/space/basic,
/area/space)
"q" = (
/obj/machinery/door/airlock/wood,
/turf/open/space/basic,
/area/space)

(1,1,1) = {"
a
a
a
a
a
a
a
"}
(2,1,1) = {"
a
a
a
a
a
a
a
"}
(3,1,1) = {"
a
a
q
q
q
a
a
"}
(4,1,1) = {"
a
a
q
q
q
a
a
"}
(5,1,1) = {"
a
a
a
a
a
a
a
"}
